1 1 1 1 1
1 0 0 0b 1
1 0 1 0 1
1 0g 0 0 1
1 1 1 1 1
